11111111111
10100000001
100CP0C0111
10000001CE1
11111111110