1111111111111
100P0C00E0041
1111111111111