1111111111111
1EC00000000P1
1001C01000001
1001C010CC001
1111111111111