11111111
100CE001
10CPC001
100C0001
11111111