11111
1E0C1
1PC01
1C101 
11111